###..###
#x...###
#S#..###
#.#..###
#.#..###
#S#..T##
###...##
#....T##
#T##.###
#.##.###
#.##.###